5 9
222222222
211111112
210000012
211111112
222222222